---
dummy:
    Just a dummy uses the first yaml document in a file
---
board:
    P.K.R.N.
    ........
    ...B....
    ........
    ........
    ........
    ........
    k.......
---
board:
    ...K....
    .KKKKK..
    ...B....
    ........
    ........
    ........
    ........
    p.......
